"filename", "language", "Java", "comment", "blank", "total"
"c:\Users\86135\Desktop\CT\projects\submit0.1\Compiler.java", "Java", 12, 0, 4, 16
"c:\Users\86135\Desktop\CT\projects\submit0.1\driver\CompilerDriver.java", "Java", 23, 1, 5, 29
"c:\Users\86135\Desktop\CT\projects\submit0.1\driver\Config.java", "Java", 102, 2, 17, 121
"c:\Users\86135\Desktop\CT\projects\submit0.1\frontend\Source.java", "Java", 51, 0, 14, 65
"c:\Users\86135\Desktop\CT\projects\submit0.1\frontend\exceptions\FrontendBaseException.java", "Java", 9, 0, 3, 12
"c:\Users\86135\Desktop\CT\projects\submit0.1\frontend\exceptions\TokenTypeNotFoundException.java", "Java", 6, 0, 3, 9
"c:\Users\86135\Desktop\CT\projects\submit0.1\frontend\tokenize\FormatStr.java", "Java", 15, 0, 5, 20
"c:\Users\86135\Desktop\CT\projects\submit0.1\frontend\tokenize\Ident.java", "Java", 9, 0, 4, 13
"c:\Users\86135\Desktop\CT\projects\submit0.1\frontend\tokenize\IntConst.java", "Java", 11, 0, 4, 15
"c:\Users\86135\Desktop\CT\projects\submit0.1\frontend\tokenize\Reserved.java", "Java", 6, 0, 2, 8
"c:\Users\86135\Desktop\CT\projects\submit0.1\frontend\tokenize\Token.java", "Java", 99, 3, 17, 119
"c:\Users\86135\Desktop\CT\projects\submit0.1\frontend\tokenize\Tokenizer.java", "Java", 69, 1, 8, 78
"Total", "-", 412, 7, 86, 505