"filename", "language", "Java", "XML", "Markdown", "Python", "comment", "blank", "total"
"c:\Users\86135\Desktop\CT\projects\dev0.2\.idea\checkstyle-idea.xml", "XML", 0, -16, 0, 0, 0, 0, -16
"c:\Users\86135\Desktop\CT\projects\dev0.2\.idea\libraries\Mars_2021.xml", "XML", 0, -9, 0, 0, 0, 0, -9
"c:\Users\86135\Desktop\CT\projects\dev0.2\.idea\libraries\Mars_20211.xml", "XML", 0, -9, 0, 0, 0, 0, -9
"c:\Users\86135\Desktop\CT\projects\dev0.2\.idea\misc.xml", "XML", 0, -11, 0, 0, 0, 0, -11
"c:\Users\86135\Desktop\CT\projects\dev0.2\.idea\modules.xml", "XML", 0, -8, 0, 0, 0, 0, -8
"c:\Users\86135\Desktop\CT\projects\dev0.2\Compiler.java", "Java", -12, 0, 0, 0, 0, -4, -16
"c:\Users\86135\Desktop\CT\projects\dev0.2\Resourse\AutoCompileTest.py", "Python", 0, 0, 0, -49, -3, -3, -55
"c:\Users\86135\Desktop\CT\projects\dev0.2\Resourse\AutoFiltedPacker.py", "Python", 0, 0, 0, -31, 0, -5, -36
"c:\Users\86135\Desktop\CT\projects\dev0.2\Resourse\AutoMatchTwo.py", "Python", 0, 0, 0, -47, -3, -3, -53
"c:\Users\86135\Desktop\CT\projects\dev0.2\Resourse\AutoMidCompare.py", "Python", 0, 0, 0, -55, -6, -4, -65
"c:\Users\86135\Desktop\CT\projects\dev0.2\Resourse\AutoMipsCompare.py", "Python", 0, 0, 0, -77, -7, -4, -88
"c:\Users\86135\Desktop\CT\projects\dev0.2\Resourse\AutoRunJar.py", "Python", 0, 0, 0, -28, -1, -3, -32
"c:\Users\86135\Desktop\CT\projects\dev0.2\Resourse\AutoTestJar.py", "Python", 0, 0, 0, -40, -2, -3, -45
"c:\Users\86135\Desktop\CT\projects\dev0.2\Resourse\ImportStyleCheck.py", "Python", 0, 0, 0, -26, 0, -3, -29
"c:\Users\86135\Desktop\CT\projects\dev0.2\Resourse\config.xml", "XML", 0, -149, 0, 0, -10, -10, -169
"c:\Users\86135\Desktop\CT\projects\dev0.2\dev0.1.iml", "XML", 0, -22, 0, 0, 0, 0, -22
"c:\Users\86135\Desktop\CT\projects\dev0.2\dev0.2.iml", "XML", 0, -22, 0, 0, 0, 0, -22
"c:\Users\86135\Desktop\CT\projects\dev0.2\driver\CompilerDriver.java", "Java", -26, 0, 0, 0, -2, -6, -34
"c:\Users\86135\Desktop\CT\projects\dev0.2\driver\Config.java", "Java", -102, 0, 0, 0, -2, -17, -121
"c:\Users\86135\Desktop\CT\projects\dev0.2\driver\Output.java", "Java", -26, 0, 0, 0, 0, -9, -35
"c:\Users\86135\Desktop\CT\projects\dev0.2\frontend\Source.java", "Java", -51, 0, 0, 0, 0, -14, -65
"c:\Users\86135\Desktop\CT\projects\dev0.2\frontend\error\Error.java", "Java", -56, 0, 0, 0, 0, -15, -71
"c:\Users\86135\Desktop\CT\projects\dev0.2\frontend\error\ErrorBuffer.java", "Java", -21, 0, 0, 0, 0, -9, -30
"c:\Users\86135\Desktop\CT\projects\dev0.2\frontend\exceptions\FrontendBaseException.java", "Java", -9, 0, 0, 0, 0, -3, -12
"c:\Users\86135\Desktop\CT\projects\dev0.2\frontend\exceptions\TokenTypeNotFoundException.java", "Java", -6, 0, 0, 0, 0, -3, -9
"c:\Users\86135\Desktop\CT\projects\dev0.2\frontend\lang_design.md", "Markdown", 0, 0, -107, 0, 0, -5, -112
"c:\Users\86135\Desktop\CT\projects\dev0.2\frontend\syntax\CompUnitParser.java", "Java", -51, 0, 0, 0, -1, -4, -56
"c:\Users\86135\Desktop\CT\projects\dev0.2\frontend\syntax\ParserBase.java", "Java", -67, 0, 0, 0, -2, -17, -86
"c:\Users\86135\Desktop\CT\projects\dev0.2\frontend\syntax\decl\parse\BTypeParser.java", "Java", -14, 0, 0, 0, 0, -3, -17
"c:\Users\86135\Desktop\CT\projects\dev0.2\frontend\syntax\decl\parse\ConstDeclParser.java", "Java", -22, 0, 0, 0, -1, -4, -27
"c:\Users\86135\Desktop\CT\projects\dev0.2\frontend\syntax\decl\parse\ConstDefParser.java", "Java", -25, 0, 0, 0, -1, -4, -30
"c:\Users\86135\Desktop\CT\projects\dev0.2\frontend\syntax\decl\parse\ConstInitValParser.java", "Java", -32, 0, 0, 0, -1, -4, -37
"c:\Users\86135\Desktop\CT\projects\dev0.2\frontend\syntax\decl\parse\InitValParser.java", "Java", -32, 0, 0, 0, -1, -4, -37
"c:\Users\86135\Desktop\CT\projects\dev0.2\frontend\syntax\decl\parse\VarDeclParser.java", "Java", -19, 0, 0, 0, -1, -4, -24
"c:\Users\86135\Desktop\CT\projects\dev0.2\frontend\syntax\decl\parse\VarDefParser.java", "Java", -24, 0, 0, 0, -1, -4, -29
"c:\Users\86135\Desktop\CT\projects\dev0.2\frontend\syntax\expr\parse\AddExpParser.java", "Java", -15, 0, 0, 0, -1, -4, -20
"c:\Users\86135\Desktop\CT\projects\dev0.2\frontend\syntax\expr\parse\CondParser.java", "Java", -10, 0, 0, 0, -1, -4, -15
"c:\Users\86135\Desktop\CT\projects\dev0.2\frontend\syntax\expr\parse\ConstExpParser.java", "Java", -10, 0, 0, 0, -1, -4, -15
"c:\Users\86135\Desktop\CT\projects\dev0.2\frontend\syntax\expr\parse\EqExpParser.java", "Java", -15, 0, 0, 0, -1, -4, -20
"c:\Users\86135\Desktop\CT\projects\dev0.2\frontend\syntax\expr\parse\ExpParser.java", "Java", -10, 0, 0, 0, -1, -3, -14
"c:\Users\86135\Desktop\CT\projects\dev0.2\frontend\syntax\expr\parse\FuncRParamsParser.java", "Java", -14, 0, 0, 0, 0, -3, -17
"c:\Users\86135\Desktop\CT\projects\dev0.2\frontend\syntax\expr\parse\LAndExpParser.java", "Java", -15, 0, 0, 0, -1, -4, -20
"c:\Users\86135\Desktop\CT\projects\dev0.2\frontend\syntax\expr\parse\LOrExpParser.java", "Java", -15, 0, 0, 0, -1, -4, -20
"c:\Users\86135\Desktop\CT\projects\dev0.2\frontend\syntax\expr\parse\LValParser.java", "Java", -20, 0, 0, 0, -1, -4, -25
"c:\Users\86135\Desktop\CT\projects\dev0.2\frontend\syntax\expr\parse\MulExpParser.java", "Java", -15, 0, 0, 0, -2, -4, -21
"c:\Users\86135\Desktop\CT\projects\dev0.2\frontend\syntax\expr\parse\NumberParser.java", "Java", -14, 0, 0, 0, -1, -4, -19
"c:\Users\86135\Desktop\CT\projects\dev0.2\frontend\syntax\expr\parse\PrimaryExpParser.java", "Java", -25, 0, 0, 0, -1, -4, -30
"c:\Users\86135\Desktop\CT\projects\dev0.2\frontend\syntax\expr\parse\RelExpParser.java", "Java", -15, 0, 0, 0, -1, -4, -20
"c:\Users\86135\Desktop\CT\projects\dev0.2\frontend\syntax\expr\parse\UnaryExpParser.java", "Java", -41, 0, 0, 0, -1, -4, -46
"c:\Users\86135\Desktop\CT\projects\dev0.2\frontend\syntax\expr\parse\UnaryOpParser.java", "Java", -14, 0, 0, 0, 0, -3, -17
"c:\Users\86135\Desktop\CT\projects\dev0.2\frontend\syntax\func\parse\FuncDefParser.java", "Java", -24, 0, 0, 0, -1, -4, -29
"c:\Users\86135\Desktop\CT\projects\dev0.2\frontend\syntax\func\parse\FuncFParamParser.java", "Java", -28, 0, 0, 0, -1, -4, -33
"c:\Users\86135\Desktop\CT\projects\dev0.2\frontend\syntax\func\parse\FuncFParamsParser.java", "Java", -14, 0, 0, 0, -1, -4, -19
"c:\Users\86135\Desktop\CT\projects\dev0.2\frontend\syntax\func\parse\FuncTypeParser.java", "Java", -14, 0, 0, 0, -1, -4, -19
"c:\Users\86135\Desktop\CT\projects\dev0.2\frontend\syntax\func\parse\MainFuncDefParser.java", "Java", -25, 0, 0, 0, -1, -4, -30
"c:\Users\86135\Desktop\CT\projects\dev0.2\frontend\syntax\stmt\parser\BlockParser.java", "Java", -33, 0, 0, 0, -1, -4, -38
"c:\Users\86135\Desktop\CT\projects\dev0.2\frontend\syntax\stmt\parser\StmtParser.java", "Java", -165, 0, 0, 0, -13, -11, -189
"c:\Users\86135\Desktop\CT\projects\dev0.2\frontend\tokenize\FormatStr.java", "Java", -15, 0, 0, 0, 0, -5, -20
"c:\Users\86135\Desktop\CT\projects\dev0.2\frontend\tokenize\Ident.java", "Java", -9, 0, 0, 0, 0, -4, -13
"c:\Users\86135\Desktop\CT\projects\dev0.2\frontend\tokenize\IntConst.java", "Java", -11, 0, 0, 0, 0, -4, -15
"c:\Users\86135\Desktop\CT\projects\dev0.2\frontend\tokenize\Reserved.java", "Java", -6, 0, 0, 0, 0, -2, -8
"c:\Users\86135\Desktop\CT\projects\dev0.2\frontend\tokenize\Token.java", "Java", -100, 0, 0, 0, -3, -18, -121
"c:\Users\86135\Desktop\CT\projects\dev0.2\frontend\tokenize\Tokenizer.java", "Java", -107, 0, 0, 0, -1, -14, -122
"c:\Users\86135\Desktop\CT\projects\dev0.2\out\production\dev0.1\.idea\checkstyle-idea.xml", "XML", 0, -16, 0, 0, 0, 0, -16
"c:\Users\86135\Desktop\CT\projects\dev0.2\out\production\dev0.1\.idea\libraries\Mars_2021.xml", "XML", 0, -9, 0, 0, 0, 0, -9
"c:\Users\86135\Desktop\CT\projects\dev0.2\out\production\dev0.1\.idea\misc.xml", "XML", 0, -11, 0, 0, 0, 0, -11
"c:\Users\86135\Desktop\CT\projects\dev0.2\out\production\dev0.1\.idea\modules.xml", "XML", 0, -8, 0, 0, 0, 0, -8
"c:\Users\86135\Desktop\CT\projects\dev0.2\out\production\dev0.1\Resourse\AutoCompileTest.py", "Python", 0, 0, 0, -49, -3, -3, -55
"c:\Users\86135\Desktop\CT\projects\dev0.2\out\production\dev0.1\Resourse\AutoFiltedPacker.py", "Python", 0, 0, 0, -31, 0, -5, -36
"c:\Users\86135\Desktop\CT\projects\dev0.2\out\production\dev0.1\Resourse\AutoMatchTwo.py", "Python", 0, 0, 0, -47, -3, -3, -53
"c:\Users\86135\Desktop\CT\projects\dev0.2\out\production\dev0.1\Resourse\AutoMidCompare.py", "Python", 0, 0, 0, -55, -6, -4, -65
"c:\Users\86135\Desktop\CT\projects\dev0.2\out\production\dev0.1\Resourse\AutoMipsCompare.py", "Python", 0, 0, 0, -77, -7, -4, -88
"c:\Users\86135\Desktop\CT\projects\dev0.2\out\production\dev0.1\Resourse\AutoRunJar.py", "Python", 0, 0, 0, -28, -1, -3, -32
"c:\Users\86135\Desktop\CT\projects\dev0.2\out\production\dev0.1\Resourse\AutoTestJar.py", "Python", 0, 0, 0, -40, -2, -3, -45
"c:\Users\86135\Desktop\CT\projects\dev0.2\out\production\dev0.1\Resourse\ImportStyleCheck.py", "Python", 0, 0, 0, -26, 0, -3, -29
"c:\Users\86135\Desktop\CT\projects\dev0.2\out\production\dev0.1\Resourse\config.xml", "XML", 0, -149, 0, 0, -10, -10, -169
"c:\Users\86135\Desktop\CT\projects\dev0.2\out\production\dev0.1\dev0.1.iml", "XML", 0, -22, 0, 0, 0, 0, -22
"c:\Users\86135\Desktop\CT\projects\dev0.2\out\production\dev0.2\.idea\checkstyle-idea.xml", "XML", 0, -16, 0, 0, 0, 0, -16
"c:\Users\86135\Desktop\CT\projects\dev0.2\out\production\dev0.2\.idea\libraries\Mars_2021.xml", "XML", 0, -9, 0, 0, 0, 0, -9
"c:\Users\86135\Desktop\CT\projects\dev0.2\out\production\dev0.2\.idea\libraries\Mars_20211.xml", "XML", 0, -9, 0, 0, 0, 0, -9
"c:\Users\86135\Desktop\CT\projects\dev0.2\out\production\dev0.2\.idea\misc.xml", "XML", 0, -11, 0, 0, 0, 0, -11
"c:\Users\86135\Desktop\CT\projects\dev0.2\out\production\dev0.2\.idea\modules.xml", "XML", 0, -8, 0, 0, 0, 0, -8
"c:\Users\86135\Desktop\CT\projects\dev0.2\out\production\dev0.2\Resourse\AutoCompileTest.py", "Python", 0, 0, 0, -49, -3, -3, -55
"c:\Users\86135\Desktop\CT\projects\dev0.2\out\production\dev0.2\Resourse\AutoFiltedPacker.py", "Python", 0, 0, 0, -31, 0, -5, -36
"c:\Users\86135\Desktop\CT\projects\dev0.2\out\production\dev0.2\Resourse\AutoMatchTwo.py", "Python", 0, 0, 0, -47, -3, -3, -53
"c:\Users\86135\Desktop\CT\projects\dev0.2\out\production\dev0.2\Resourse\AutoMidCompare.py", "Python", 0, 0, 0, -55, -6, -4, -65
"c:\Users\86135\Desktop\CT\projects\dev0.2\out\production\dev0.2\Resourse\AutoMipsCompare.py", "Python", 0, 0, 0, -77, -7, -4, -88
"c:\Users\86135\Desktop\CT\projects\dev0.2\out\production\dev0.2\Resourse\AutoRunJar.py", "Python", 0, 0, 0, -28, -1, -3, -32
"c:\Users\86135\Desktop\CT\projects\dev0.2\out\production\dev0.2\Resourse\AutoTestJar.py", "Python", 0, 0, 0, -40, -2, -3, -45
"c:\Users\86135\Desktop\CT\projects\dev0.2\out\production\dev0.2\Resourse\ImportStyleCheck.py", "Python", 0, 0, 0, -26, 0, -3, -29
"c:\Users\86135\Desktop\CT\projects\dev0.2\out\production\dev0.2\Resourse\config.xml", "XML", 0, -149, 0, 0, -10, -10, -169
"c:\Users\86135\Desktop\CT\projects\dev0.2\out\production\dev0.2\dev0.1.iml", "XML", 0, -22, 0, 0, 0, 0, -22
"c:\Users\86135\Desktop\CT\projects\dev0.2\out\production\dev0.2\dev0.2.iml", "XML", 0, -22, 0, 0, 0, 0, -22
"c:\Users\86135\Desktop\CT\projects\dev0.2\out\production\dev0.2\frontend\lang_design.md", "Markdown", 0, 0, -107, 0, 0, -5, -112
"c:\Users\86135\Desktop\CT\projects\dev0.2\out\production\dev0.2\todo_checker.md", "Markdown", 0, 0, -13, 0, 0, -1, -14
"c:\Users\86135\Desktop\CT\projects\dev0.2\todo_checker.md", "Markdown", 0, 0, -13, 0, 0, -1, -14
"c:\Users\86135\Desktop\CT\projects\dev0.2\util\Pair.java", "Java", -35, 0, 0, 0, 0, -9, -44
"c:\Users\86135\Desktop\CT\projects\dev0.3\.idea\checkstyle-idea.xml", "XML", 0, 16, 0, 0, 0, 0, 16
"c:\Users\86135\Desktop\CT\projects\dev0.3\.idea\libraries\Compiler_21_dhy.xml", "XML", 0, 9, 0, 0, 0, 0, 9
"c:\Users\86135\Desktop\CT\projects\dev0.3\.idea\libraries\Mars_2021.xml", "XML", 0, 9, 0, 0, 0, 0, 9
"c:\Users\86135\Desktop\CT\projects\dev0.3\.idea\libraries\Mars_20211.xml", "XML", 0, 9, 0, 0, 0, 0, 9
"c:\Users\86135\Desktop\CT\projects\dev0.3\.idea\libraries\Mars_20212.xml", "XML", 0, 9, 0, 0, 0, 0, 9
"c:\Users\86135\Desktop\CT\projects\dev0.3\.idea\libraries\autotest.xml", "XML", 0, 11, 0, 0, 0, 0, 11
"c:\Users\86135\Desktop\CT\projects\dev0.3\.idea\libraries\dev0_2.xml", "XML", 0, 9, 0, 0, 0, 0, 9
"c:\Users\86135\Desktop\CT\projects\dev0.3\.idea\misc.xml", "XML", 0, 11, 0, 0, 0, 0, 11
"c:\Users\86135\Desktop\CT\projects\dev0.3\.idea\modules.xml", "XML", 0, 8, 0, 0, 0, 0, 8
"c:\Users\86135\Desktop\CT\projects\dev0.3\.idea\uiDesigner.xml", "XML", 0, 124, 0, 0, 0, 0, 124
"c:\Users\86135\Desktop\CT\projects\dev0.3\.idea\vcs.xml", "XML", 0, 6, 0, 0, 0, 0, 6
"c:\Users\86135\Desktop\CT\projects\dev0.3\Compiler.java", "Java", 12, 0, 0, 0, 0, 4, 16
"c:\Users\86135\Desktop\CT\projects\dev0.3\Resourse\AutoCompileTest.py", "Python", 0, 0, 0, 49, 3, 3, 55
"c:\Users\86135\Desktop\CT\projects\dev0.3\Resourse\AutoFiltedPacker.py", "Python", 0, 0, 0, 31, 0, 5, 36
"c:\Users\86135\Desktop\CT\projects\dev0.3\Resourse\AutoMatchTwo.py", "Python", 0, 0, 0, 57, 4, 6, 67
"c:\Users\86135\Desktop\CT\projects\dev0.3\Resourse\AutoMidCompare.py", "Python", 0, 0, 0, 55, 6, 4, 65
"c:\Users\86135\Desktop\CT\projects\dev0.3\Resourse\AutoMipsCompare.py", "Python", 0, 0, 0, 77, 7, 4, 88
"c:\Users\86135\Desktop\CT\projects\dev0.3\Resourse\AutoRunJar.py", "Python", 0, 0, 0, 28, 1, 3, 32
"c:\Users\86135\Desktop\CT\projects\dev0.3\Resourse\AutoTestJar.py", "Python", 0, 0, 0, 40, 2, 3, 45
"c:\Users\86135\Desktop\CT\projects\dev0.3\Resourse\ImportStyleCheck.py", "Python", 0, 0, 0, 26, 0, 3, 29
"c:\Users\86135\Desktop\CT\projects\dev0.3\Resourse\config.xml", "XML", 0, 149, 0, 0, 10, 10, 169
"c:\Users\86135\Desktop\CT\projects\dev0.3\autotest\AutoMatchTwo.py", "Python", 0, 0, 0, 65, 4, 6, 75
"c:\Users\86135\Desktop\CT\projects\dev0.3\dev0.1.iml", "XML", 0, 22, 0, 0, 0, 0, 22
"c:\Users\86135\Desktop\CT\projects\dev0.3\dev0.2.iml", "XML", 0, 22, 0, 0, 0, 0, 22
"c:\Users\86135\Desktop\CT\projects\dev0.3\dev0.3.iml", "XML", 0, 22, 0, 0, 0, 0, 22
"c:\Users\86135\Desktop\CT\projects\dev0.3\driver\CompilerDriver.java", "Java", 31, 0, 0, 0, 2, 6, 39
"c:\Users\86135\Desktop\CT\projects\dev0.3\driver\Config.java", "Java", 102, 0, 0, 0, 2, 17, 121
"c:\Users\86135\Desktop\CT\projects\dev0.3\driver\Output.java", "Java", 35, 0, 0, 0, 0, 11, 46
"c:\Users\86135\Desktop\CT\projects\dev0.3\frontend\Source.java", "Java", 51, 0, 0, 0, 0, 14, 65
"c:\Users\86135\Desktop\CT\projects\dev0.3\frontend\error\Error.java", "Java", 56, 0, 0, 0, 0, 15, 71
"c:\Users\86135\Desktop\CT\projects\dev0.3\frontend\error\ErrorBuffer.java", "Java", 21, 0, 0, 0, 0, 9, 30
"c:\Users\86135\Desktop\CT\projects\dev0.3\frontend\exceptions\FrontendBaseException.java", "Java", 9, 0, 0, 0, 0, 3, 12
"c:\Users\86135\Desktop\CT\projects\dev0.3\frontend\exceptions\TokenTypeNotFoundException.java", "Java", 6, 0, 0, 0, 0, 3, 9
"c:\Users\86135\Desktop\CT\projects\dev0.3\frontend\lang_design.md", "Markdown", 0, 0, 162, 0, 0, 20, 182
"c:\Users\86135\Desktop\CT\projects\dev0.3\frontend\syntax\CompUnitParser.java", "Java", 51, 0, 0, 0, 1, 4, 56
"c:\Users\86135\Desktop\CT\projects\dev0.3\frontend\syntax\NodeBase.java", "Java", 54, 0, 0, 0, 0, 12, 66
"c:\Users\86135\Desktop\CT\projects\dev0.3\frontend\syntax\ParserBase.java", "Java", 79, 0, 0, 0, 4, 22, 105
"c:\Users\86135\Desktop\CT\projects\dev0.3\frontend\syntax\TokenNode.java", "Java", 14, 0, 0, 0, 0, 6, 20
"c:\Users\86135\Desktop\CT\projects\dev0.3\frontend\syntax\decl\ast\InitValNode.java", "Java", 12, 0, 0, 0, 0, 6, 18
"c:\Users\86135\Desktop\CT\projects\dev0.3\frontend\syntax\decl\ast\VarDeclNode.java", "Java", 15, 0, 0, 0, 4, 6, 25
"c:\Users\86135\Desktop\CT\projects\dev0.3\frontend\syntax\decl\ast\VarDefNode.java", "Java", 17, 0, 0, 0, 0, 6, 23
"c:\Users\86135\Desktop\CT\projects\dev0.3\frontend\syntax\decl\parse\BTypeParser.java", "Java", 17, 0, 0, 0, 0, 4, 21
"c:\Users\86135\Desktop\CT\projects\dev0.3\frontend\syntax\decl\parse\ConstDeclParser.java", "Java", 29, 0, 0, 0, 1, 6, 36
"c:\Users\86135\Desktop\CT\projects\dev0.3\frontend\syntax\decl\parse\ConstDefParser.java", "Java", 35, 0, 0, 0, 1, 6, 42
"c:\Users\86135\Desktop\CT\projects\dev0.3\frontend\syntax\decl\parse\ConstInitValParser.java", "Java", 38, 0, 0, 0, 1, 6, 45
"c:\Users\86135\Desktop\CT\projects\dev0.3\frontend\syntax\decl\parse\InitValParser.java", "Java", 38, 0, 0, 0, 1, 6, 45
"c:\Users\86135\Desktop\CT\projects\dev0.3\frontend\syntax\decl\parse\VarDeclParser.java", "Java", 25, 0, 0, 0, 1, 6, 32
"c:\Users\86135\Desktop\CT\projects\dev0.3\frontend\syntax\decl\parse\VarDefParser.java", "Java", 33, 0, 0, 0, 1, 6, 40
"c:\Users\86135\Desktop\CT\projects\dev0.3\frontend\syntax\expr\ast\BinaryExpNode.java", "Java", 17, 0, 0, 0, 2, 6, 25
"c:\Users\86135\Desktop\CT\projects\dev0.3\frontend\syntax\expr\ast\FuncCallNode.java", "Java", 14, 0, 0, 0, 1, 5, 20
"c:\Users\86135\Desktop\CT\projects\dev0.3\frontend\syntax\expr\ast\FuncRParamsNode.java", "Java", 12, 0, 0, 0, 1, 5, 18
"c:\Users\86135\Desktop\CT\projects\dev0.3\frontend\syntax\expr\ast\LValNode.java", "Java", 15, 0, 0, 0, 1, 6, 22
"c:\Users\86135\Desktop\CT\projects\dev0.3\frontend\syntax\expr\ast\UnaryExpNode.java", "Java", 13, 0, 0, 0, 0, 5, 18
"c:\Users\86135\Desktop\CT\projects\dev0.3\frontend\syntax\expr\parse\AddExpParser.java", "Java", 24, 0, 0, 0, 1, 8, 33
"c:\Users\86135\Desktop\CT\projects\dev0.3\frontend\syntax\expr\parse\CondParser.java", "Java", 11, 0, 0, 0, 1, 4, 16
"c:\Users\86135\Desktop\CT\projects\dev0.3\frontend\syntax\expr\parse\ConstExpParser.java", "Java", 11, 0, 0, 0, 1, 4, 16
"c:\Users\86135\Desktop\CT\projects\dev0.3\frontend\syntax\expr\parse\EqExpParser.java", "Java", 24, 0, 0, 0, 1, 8, 33
"c:\Users\86135\Desktop\CT\projects\dev0.3\frontend\syntax\expr\parse\ExpParser.java", "Java", 12, 0, 0, 0, 1, 3, 16
"c:\Users\86135\Desktop\CT\projects\dev0.3\frontend\syntax\expr\parse\FuncRParamsParser.java", "Java", 20, 0, 0, 0, 0, 6, 26
"c:\Users\86135\Desktop\CT\projects\dev0.3\frontend\syntax\expr\parse\LAndExpParser.java", "Java", 24, 0, 0, 0, 1, 8, 33
"c:\Users\86135\Desktop\CT\projects\dev0.3\frontend\syntax\expr\parse\LOrExpParser.java", "Java", 24, 0, 0, 0, 1, 8, 33
"c:\Users\86135\Desktop\CT\projects\dev0.3\frontend\syntax\expr\parse\LValParser.java", "Java", 28, 0, 0, 0, 1, 7, 36
"c:\Users\86135\Desktop\CT\projects\dev0.3\frontend\syntax\expr\parse\MulExpParser.java", "Java", 24, 0, 0, 0, 2, 8, 34
"c:\Users\86135\Desktop\CT\projects\dev0.3\frontend\syntax\expr\parse\NumberParser.java", "Java", 18, 0, 0, 0, 1, 5, 24
"c:\Users\86135\Desktop\CT\projects\dev0.3\frontend\syntax\expr\parse\PrimaryExpParser.java", "Java", 26, 0, 0, 0, 1, 5, 32
"c:\Users\86135\Desktop\CT\projects\dev0.3\frontend\syntax\expr\parse\RelExpParser.java", "Java", 24, 0, 0, 0, 1, 8, 33
"c:\Users\86135\Desktop\CT\projects\dev0.3\frontend\syntax\expr\parse\UnaryExpParser.java", "Java", 50, 0, 0, 0, 1, 9, 60
"c:\Users\86135\Desktop\CT\projects\dev0.3\frontend\syntax\expr\parse\UnaryOpParser.java", "Java", 18, 0, 0, 0, 0, 6, 24
"c:\Users\86135\Desktop\CT\projects\dev0.3\frontend\syntax\func\parse\FuncDefParser.java", "Java", 26, 0, 0, 0, 1, 4, 31
"c:\Users\86135\Desktop\CT\projects\dev0.3\frontend\syntax\func\parse\FuncFParamParser.java", "Java", 28, 0, 0, 0, 1, 4, 33
"c:\Users\86135\Desktop\CT\projects\dev0.3\frontend\syntax\func\parse\FuncFParamsParser.java", "Java", 14, 0, 0, 0, 1, 4, 19
"c:\Users\86135\Desktop\CT\projects\dev0.3\frontend\syntax\func\parse\FuncTypeParser.java", "Java", 14, 0, 0, 0, 1, 4, 19
"c:\Users\86135\Desktop\CT\projects\dev0.3\frontend\syntax\func\parse\MainFuncDefParser.java", "Java", 25, 0, 0, 0, 1, 4, 30
"c:\Users\86135\Desktop\CT\projects\dev0.3\frontend\syntax\stmt\ast\AssignNode.java", "Java", 13, 0, 0, 0, 0, 5, 18
"c:\Users\86135\Desktop\CT\projects\dev0.3\frontend\syntax\stmt\ast\BlockNode.java", "Java", 11, 0, 0, 0, 0, 5, 16
"c:\Users\86135\Desktop\CT\projects\dev0.3\frontend\syntax\stmt\ast\BreakNode.java", "Java", 7, 0, 0, 0, 0, 3, 10
"c:\Users\86135\Desktop\CT\projects\dev0.3\frontend\syntax\stmt\ast\ConditionNode.java", "Java", 16, 0, 0, 0, 0, 5, 21
"c:\Users\86135\Desktop\CT\projects\dev0.3\frontend\syntax\stmt\ast\ContinueNode.java", "Java", 7, 0, 0, 0, 0, 3, 10
"c:\Users\86135\Desktop\CT\projects\dev0.3\frontend\syntax\stmt\ast\GetintNode.java", "Java", 11, 0, 0, 0, 0, 5, 16
"c:\Users\86135\Desktop\CT\projects\dev0.3\frontend\syntax\stmt\ast\LoopNode.java", "Java", 13, 0, 0, 0, 0, 5, 18
"c:\Users\86135\Desktop\CT\projects\dev0.3\frontend\syntax\stmt\ast\PrintNode.java", "Java", 15, 0, 0, 0, 0, 6, 21
"c:\Users\86135\Desktop\CT\projects\dev0.3\frontend\syntax\stmt\ast\ReturnNode.java", "Java", 11, 0, 0, 0, 0, 5, 16
"c:\Users\86135\Desktop\CT\projects\dev0.3\frontend\syntax\stmt\parser\BlockParser.java", "Java", 35, 0, 0, 0, 1, 4, 40
"c:\Users\86135\Desktop\CT\projects\dev0.3\frontend\syntax\stmt\parser\StmtParser.java", "Java", 168, 0, 0, 0, 13, 11, 192
"c:\Users\86135\Desktop\CT\projects\dev0.3\frontend\syntax_design.md", "Markdown", 0, 0, 149, 0, 0, 7, 156
"c:\Users\86135\Desktop\CT\projects\dev0.3\frontend\tokenize\FormatStr.java", "Java", 15, 0, 0, 0, 0, 5, 20
"c:\Users\86135\Desktop\CT\projects\dev0.3\frontend\tokenize\Ident.java", "Java", 9, 0, 0, 0, 0, 4, 13
"c:\Users\86135\Desktop\CT\projects\dev0.3\frontend\tokenize\IntConst.java", "Java", 12, 0, 0, 0, 0, 5, 17
"c:\Users\86135\Desktop\CT\projects\dev0.3\frontend\tokenize\Reserved.java", "Java", 6, 0, 0, 0, 0, 2, 8
"c:\Users\86135\Desktop\CT\projects\dev0.3\frontend\tokenize\Token.java", "Java", 120, 0, 0, 0, 3, 20, 143
"c:\Users\86135\Desktop\CT\projects\dev0.3\frontend\tokenize\Tokenizer.java", "Java", 123, 0, 0, 0, 6, 19, 148
"c:\Users\86135\Desktop\CT\projects\dev0.3\out\production\dev0.1\.idea\checkstyle-idea.xml", "XML", 0, 16, 0, 0, 0, 0, 16
"c:\Users\86135\Desktop\CT\projects\dev0.3\out\production\dev0.1\.idea\libraries\Mars_2021.xml", "XML", 0, 9, 0, 0, 0, 0, 9
"c:\Users\86135\Desktop\CT\projects\dev0.3\out\production\dev0.1\.idea\misc.xml", "XML", 0, 11, 0, 0, 0, 0, 11
"c:\Users\86135\Desktop\CT\projects\dev0.3\out\production\dev0.1\.idea\modules.xml", "XML", 0, 8, 0, 0, 0, 0, 8
"c:\Users\86135\Desktop\CT\projects\dev0.3\out\production\dev0.1\Resourse\AutoCompileTest.py", "Python", 0, 0, 0, 49, 3, 3, 55
"c:\Users\86135\Desktop\CT\projects\dev0.3\out\production\dev0.1\Resourse\AutoFiltedPacker.py", "Python", 0, 0, 0, 31, 0, 5, 36
"c:\Users\86135\Desktop\CT\projects\dev0.3\out\production\dev0.1\Resourse\AutoMatchTwo.py", "Python", 0, 0, 0, 47, 3, 3, 53
"c:\Users\86135\Desktop\CT\projects\dev0.3\out\production\dev0.1\Resourse\AutoMidCompare.py", "Python", 0, 0, 0, 55, 6, 4, 65
"c:\Users\86135\Desktop\CT\projects\dev0.3\out\production\dev0.1\Resourse\AutoMipsCompare.py", "Python", 0, 0, 0, 77, 7, 4, 88
"c:\Users\86135\Desktop\CT\projects\dev0.3\out\production\dev0.1\Resourse\AutoRunJar.py", "Python", 0, 0, 0, 28, 1, 3, 32
"c:\Users\86135\Desktop\CT\projects\dev0.3\out\production\dev0.1\Resourse\AutoTestJar.py", "Python", 0, 0, 0, 40, 2, 3, 45
"c:\Users\86135\Desktop\CT\projects\dev0.3\out\production\dev0.1\Resourse\ImportStyleCheck.py", "Python", 0, 0, 0, 26, 0, 3, 29
"c:\Users\86135\Desktop\CT\projects\dev0.3\out\production\dev0.1\Resourse\config.xml", "XML", 0, 149, 0, 0, 10, 10, 169
"c:\Users\86135\Desktop\CT\projects\dev0.3\out\production\dev0.1\dev0.1.iml", "XML", 0, 22, 0, 0, 0, 0, 22
"c:\Users\86135\Desktop\CT\projects\dev0.3\out\production\dev0.2\.idea\artifacts\dev0_2_jar.xml", "XML", 0, 8, 0, 0, 0, 0, 8
"c:\Users\86135\Desktop\CT\projects\dev0.3\out\production\dev0.2\.idea\checkstyle-idea.xml", "XML", 0, 16, 0, 0, 0, 0, 16
"c:\Users\86135\Desktop\CT\projects\dev0.3\out\production\dev0.2\.idea\libraries\Mars_2021.xml", "XML", 0, 9, 0, 0, 0, 0, 9
"c:\Users\86135\Desktop\CT\projects\dev0.3\out\production\dev0.2\.idea\libraries\Mars_20211.xml", "XML", 0, 9, 0, 0, 0, 0, 9
"c:\Users\86135\Desktop\CT\projects\dev0.3\out\production\dev0.2\.idea\misc.xml", "XML", 0, 11, 0, 0, 0, 0, 11
"c:\Users\86135\Desktop\CT\projects\dev0.3\out\production\dev0.2\.idea\modules.xml", "XML", 0, 8, 0, 0, 0, 0, 8
"c:\Users\86135\Desktop\CT\projects\dev0.3\out\production\dev0.2\.idea\vcs.xml", "XML", 0, 6, 0, 0, 0, 0, 6
"c:\Users\86135\Desktop\CT\projects\dev0.3\out\production\dev0.2\Resourse\AutoCompileTest.py", "Python", 0, 0, 0, 49, 3, 3, 55
"c:\Users\86135\Desktop\CT\projects\dev0.3\out\production\dev0.2\Resourse\AutoFiltedPacker.py", "Python", 0, 0, 0, 31, 0, 5, 36
"c:\Users\86135\Desktop\CT\projects\dev0.3\out\production\dev0.2\Resourse\AutoMatchTwo.py", "Python", 0, 0, 0, 47, 3, 3, 53
"c:\Users\86135\Desktop\CT\projects\dev0.3\out\production\dev0.2\Resourse\AutoMidCompare.py", "Python", 0, 0, 0, 55, 6, 4, 65
"c:\Users\86135\Desktop\CT\projects\dev0.3\out\production\dev0.2\Resourse\AutoMipsCompare.py", "Python", 0, 0, 0, 77, 7, 4, 88
"c:\Users\86135\Desktop\CT\projects\dev0.3\out\production\dev0.2\Resourse\AutoRunJar.py", "Python", 0, 0, 0, 28, 1, 3, 32
"c:\Users\86135\Desktop\CT\projects\dev0.3\out\production\dev0.2\Resourse\AutoTestJar.py", "Python", 0, 0, 0, 40, 2, 3, 45
"c:\Users\86135\Desktop\CT\projects\dev0.3\out\production\dev0.2\Resourse\ImportStyleCheck.py", "Python", 0, 0, 0, 26, 0, 3, 29
"c:\Users\86135\Desktop\CT\projects\dev0.3\out\production\dev0.2\Resourse\config.xml", "XML", 0, 149, 0, 0, 10, 10, 169
"c:\Users\86135\Desktop\CT\projects\dev0.3\out\production\dev0.2\autotest\AutoMatchTwo.py", "Python", 0, 0, 0, 47, 3, 3, 53
"c:\Users\86135\Desktop\CT\projects\dev0.3\out\production\dev0.2\dev0.1.iml", "XML", 0, 22, 0, 0, 0, 0, 22
"c:\Users\86135\Desktop\CT\projects\dev0.3\out\production\dev0.2\dev0.2.iml", "XML", 0, 22, 0, 0, 0, 0, 22
"c:\Users\86135\Desktop\CT\projects\dev0.3\out\production\dev0.2\frontend\lang_design.md", "Markdown", 0, 0, 107, 0, 0, 5, 112
"c:\Users\86135\Desktop\CT\projects\dev0.3\out\production\dev0.2\todo_checker.md", "Markdown", 0, 0, 20, 0, 0, 3, 23
"c:\Users\86135\Desktop\CT\projects\dev0.3\todo_checker.md", "Markdown", 0, 0, 48, 0, 0, 12, 60
"c:\Users\86135\Desktop\CT\projects\dev0.3\util\Pair.java", "Java", 35, 0, 0, 0, 0, 9, 44
"Total", "-", 494, 204, 246, 122, 24, 220, 1310