"filename", "language", "XML", "Markdown", "Java", "Python", "comment", "blank", "total"
"c:\Users\86135\Desktop\CT\projects\dev0.3\.idea\artifacts\dev0_3_jar.xml", "XML", 8, 0, 0, 0, 0, 0, 8
"c:\Users\86135\Desktop\CT\projects\dev0.3\.idea\checkstyle-idea.xml", "XML", 16, 0, 0, 0, 0, 0, 16
"c:\Users\86135\Desktop\CT\projects\dev0.3\.idea\libraries\Compiler_21_dhy.xml", "XML", 9, 0, 0, 0, 0, 0, 9
"c:\Users\86135\Desktop\CT\projects\dev0.3\.idea\libraries\Mars_2021.xml", "XML", 9, 0, 0, 0, 0, 0, 9
"c:\Users\86135\Desktop\CT\projects\dev0.3\.idea\libraries\Mars_20211.xml", "XML", 9, 0, 0, 0, 0, 0, 9
"c:\Users\86135\Desktop\CT\projects\dev0.3\.idea\libraries\Mars_20212.xml", "XML", 9, 0, 0, 0, 0, 0, 9
"c:\Users\86135\Desktop\CT\projects\dev0.3\.idea\libraries\autotest.xml", "XML", 11, 0, 0, 0, 0, 0, 11
"c:\Users\86135\Desktop\CT\projects\dev0.3\.idea\libraries\dev0_2.xml", "XML", 9, 0, 0, 0, 0, 0, 9
"c:\Users\86135\Desktop\CT\projects\dev0.3\.idea\misc.xml", "XML", 11, 0, 0, 0, 0, 0, 11
"c:\Users\86135\Desktop\CT\projects\dev0.3\.idea\modules.xml", "XML", 8, 0, 0, 0, 0, 0, 8
"c:\Users\86135\Desktop\CT\projects\dev0.3\.idea\uiDesigner.xml", "XML", 124, 0, 0, 0, 0, 0, 124
"c:\Users\86135\Desktop\CT\projects\dev0.3\.idea\vcs.xml", "XML", 6, 0, 0, 0, 0, 0, 6
"c:\Users\86135\Desktop\CT\projects\dev0.3\Compiler.java", "Java", 0, 0, 12, 0, 0, 4, 16
"c:\Users\86135\Desktop\CT\projects\dev0.3\Resourse\AutoCompileTest.py", "Python", 0, 0, 0, 49, 3, 3, 55
"c:\Users\86135\Desktop\CT\projects\dev0.3\Resourse\AutoFiltedPacker.py", "Python", 0, 0, 0, 31, 0, 5, 36
"c:\Users\86135\Desktop\CT\projects\dev0.3\Resourse\AutoMatchTwo.py", "Python", 0, 0, 0, 57, 4, 6, 67
"c:\Users\86135\Desktop\CT\projects\dev0.3\Resourse\AutoMidCompare.py", "Python", 0, 0, 0, 55, 6, 4, 65
"c:\Users\86135\Desktop\CT\projects\dev0.3\Resourse\AutoMipsCompare.py", "Python", 0, 0, 0, 77, 7, 4, 88
"c:\Users\86135\Desktop\CT\projects\dev0.3\Resourse\AutoRunJar.py", "Python", 0, 0, 0, 28, 1, 3, 32
"c:\Users\86135\Desktop\CT\projects\dev0.3\Resourse\AutoTestJar.py", "Python", 0, 0, 0, 40, 2, 3, 45
"c:\Users\86135\Desktop\CT\projects\dev0.3\Resourse\ImportStyleCheck.py", "Python", 0, 0, 0, 26, 0, 3, 29
"c:\Users\86135\Desktop\CT\projects\dev0.3\Resourse\config.xml", "XML", 149, 0, 0, 0, 10, 10, 169
"c:\Users\86135\Desktop\CT\projects\dev0.3\autotest\AutoMatchTwo.py", "Python", 0, 0, 0, 65, 4, 6, 75
"c:\Users\86135\Desktop\CT\projects\dev0.3\dev0.1.iml", "XML", 22, 0, 0, 0, 0, 0, 22
"c:\Users\86135\Desktop\CT\projects\dev0.3\dev0.2.iml", "XML", 22, 0, 0, 0, 0, 0, 22
"c:\Users\86135\Desktop\CT\projects\dev0.3\dev0.3.iml", "XML", 22, 0, 0, 0, 0, 0, 22
"c:\Users\86135\Desktop\CT\projects\dev0.3\driver\CompilerDriver.java", "Java", 0, 0, 31, 0, 2, 6, 39
"c:\Users\86135\Desktop\CT\projects\dev0.3\driver\Config.java", "Java", 0, 0, 110, 0, 2, 17, 129
"c:\Users\86135\Desktop\CT\projects\dev0.3\driver\Output.java", "Java", 0, 0, 38, 0, 0, 11, 49
"c:\Users\86135\Desktop\CT\projects\dev0.3\frontend\Source.java", "Java", 0, 0, 51, 0, 0, 14, 65
"c:\Users\86135\Desktop\CT\projects\dev0.3\frontend\error\Error.java", "Java", 0, 0, 56, 0, 0, 15, 71
"c:\Users\86135\Desktop\CT\projects\dev0.3\frontend\error\ErrorBuffer.java", "Java", 0, 0, 21, 0, 0, 9, 30
"c:\Users\86135\Desktop\CT\projects\dev0.3\frontend\exceptions\FrontendBaseException.java", "Java", 0, 0, 12, 0, 0, 4, 16
"c:\Users\86135\Desktop\CT\projects\dev0.3\frontend\exceptions\TokenTypeNotFoundException.java", "Java", 0, 0, 6, 0, 0, 3, 9
"c:\Users\86135\Desktop\CT\projects\dev0.3\frontend\lang_design.md", "Markdown", 0, 162, 0, 0, 0, 20, 182
"c:\Users\86135\Desktop\CT\projects\dev0.3\frontend\symbol\FuncSymbol.java", "Java", 0, 0, 33, 0, 0, 11, 44
"c:\Users\86135\Desktop\CT\projects\dev0.3\frontend\symbol\LValSymbol.java", "Java", 0, 0, 49, 0, 0, 14, 63
"c:\Users\86135\Desktop\CT\projects\dev0.3\frontend\symbol\Symbol.java", "Java", 0, 0, 4, 0, 0, 2, 6
"c:\Users\86135\Desktop\CT\projects\dev0.3\frontend\symbol\SymbolTable.java", "Java", 0, 0, 63, 0, 0, 13, 76
"c:\Users\86135\Desktop\CT\projects\dev0.3\frontend\syntax\CompUnitParser.java", "Java", 0, 0, 56, 0, 1, 5, 62
"c:\Users\86135\Desktop\CT\projects\dev0.3\frontend\syntax\NodeBase.java", "Java", 0, 0, 77, 0, 3, 17, 97
"c:\Users\86135\Desktop\CT\projects\dev0.3\frontend\syntax\ParserBase.java", "Java", 0, 0, 79, 0, 4, 22, 105
"c:\Users\86135\Desktop\CT\projects\dev0.3\frontend\syntax\RootNode.java", "Java", 0, 0, 34, 0, 5, 10, 49
"c:\Users\86135\Desktop\CT\projects\dev0.3\frontend\syntax\Scope.java", "Java", 0, 0, 5, 0, 0, 3, 8
"c:\Users\86135\Desktop\CT\projects\dev0.3\frontend\syntax\TokenNode.java", "Java", 0, 0, 24, 0, 0, 11, 35
"c:\Users\86135\Desktop\CT\projects\dev0.3\frontend\syntax\decl\ast\InitValNode.java", "Java", 0, 0, 42, 0, 0, 7, 49
"c:\Users\86135\Desktop\CT\projects\dev0.3\frontend\syntax\decl\ast\VarDeclNode.java", "Java", 0, 0, 25, 0, 5, 8, 38
"c:\Users\86135\Desktop\CT\projects\dev0.3\frontend\syntax\decl\ast\VarDefNode.java", "Java", 0, 0, 45, 0, 0, 7, 52
"c:\Users\86135\Desktop\CT\projects\dev0.3\frontend\syntax\decl\parse\BTypeParser.java", "Java", 0, 0, 17, 0, 0, 4, 21
"c:\Users\86135\Desktop\CT\projects\dev0.3\frontend\syntax\decl\parse\ConstDeclParser.java", "Java", 0, 0, 29, 0, 1, 6, 36
"c:\Users\86135\Desktop\CT\projects\dev0.3\frontend\syntax\decl\parse\ConstDefParser.java", "Java", 0, 0, 35, 0, 1, 6, 42
"c:\Users\86135\Desktop\CT\projects\dev0.3\frontend\syntax\decl\parse\ConstInitValParser.java", "Java", 0, 0, 38, 0, 1, 6, 45
"c:\Users\86135\Desktop\CT\projects\dev0.3\frontend\syntax\decl\parse\InitValParser.java", "Java", 0, 0, 38, 0, 1, 6, 45
"c:\Users\86135\Desktop\CT\projects\dev0.3\frontend\syntax\decl\parse\VarDeclParser.java", "Java", 0, 0, 25, 0, 1, 6, 32
"c:\Users\86135\Desktop\CT\projects\dev0.3\frontend\syntax\decl\parse\VarDefParser.java", "Java", 0, 0, 33, 0, 1, 6, 40
"c:\Users\86135\Desktop\CT\projects\dev0.3\frontend\syntax\expr\ast\BinaryExpNode.java", "Java", 0, 0, 90, 0, 2, 10, 102
"c:\Users\86135\Desktop\CT\projects\dev0.3\frontend\syntax\expr\ast\Calculatable.java", "Java", 0, 0, 5, 0, 1, 2, 8
"c:\Users\86135\Desktop\CT\projects\dev0.3\frontend\syntax\expr\ast\ExpContext.java", "Java", 0, 0, 26, 0, 1, 8, 35
"c:\Users\86135\Desktop\CT\projects\dev0.3\frontend\syntax\expr\ast\FuncCallNode.java", "Java", 0, 0, 33, 0, 1, 10, 44
"c:\Users\86135\Desktop\CT\projects\dev0.3\frontend\syntax\expr\ast\FuncRParamsNode.java", "Java", 0, 0, 28, 0, 1, 6, 35
"c:\Users\86135\Desktop\CT\projects\dev0.3\frontend\syntax\expr\ast\LValNode.java", "Java", 0, 0, 70, 0, 5, 11, 86
"c:\Users\86135\Desktop\CT\projects\dev0.3\frontend\syntax\expr\ast\UnaryExpNode.java", "Java", 0, 0, 43, 0, 1, 10, 54
"c:\Users\86135\Desktop\CT\projects\dev0.3\frontend\syntax\expr\parse\AddExpParser.java", "Java", 0, 0, 24, 0, 1, 8, 33
"c:\Users\86135\Desktop\CT\projects\dev0.3\frontend\syntax\expr\parse\CondParser.java", "Java", 0, 0, 11, 0, 1, 4, 16
"c:\Users\86135\Desktop\CT\projects\dev0.3\frontend\syntax\expr\parse\ConstExpParser.java", "Java", 0, 0, 11, 0, 1, 4, 16
"c:\Users\86135\Desktop\CT\projects\dev0.3\frontend\syntax\expr\parse\EqExpParser.java", "Java", 0, 0, 24, 0, 1, 8, 33
"c:\Users\86135\Desktop\CT\projects\dev0.3\frontend\syntax\expr\parse\ExpParser.java", "Java", 0, 0, 12, 0, 1, 3, 16
"c:\Users\86135\Desktop\CT\projects\dev0.3\frontend\syntax\expr\parse\FuncRParamsParser.java", "Java", 0, 0, 20, 0, 0, 6, 26
"c:\Users\86135\Desktop\CT\projects\dev0.3\frontend\syntax\expr\parse\LAndExpParser.java", "Java", 0, 0, 24, 0, 1, 8, 33
"c:\Users\86135\Desktop\CT\projects\dev0.3\frontend\syntax\expr\parse\LOrExpParser.java", "Java", 0, 0, 24, 0, 1, 8, 33
"c:\Users\86135\Desktop\CT\projects\dev0.3\frontend\syntax\expr\parse\LValParser.java", "Java", 0, 0, 28, 0, 1, 7, 36
"c:\Users\86135\Desktop\CT\projects\dev0.3\frontend\syntax\expr\parse\MulExpParser.java", "Java", 0, 0, 24, 0, 2, 8, 34
"c:\Users\86135\Desktop\CT\projects\dev0.3\frontend\syntax\expr\parse\NumberParser.java", "Java", 0, 0, 18, 0, 1, 5, 24
"c:\Users\86135\Desktop\CT\projects\dev0.3\frontend\syntax\expr\parse\PrimaryExpParser.java", "Java", 0, 0, 26, 0, 1, 5, 32
"c:\Users\86135\Desktop\CT\projects\dev0.3\frontend\syntax\expr\parse\RelExpParser.java", "Java", 0, 0, 24, 0, 1, 8, 33
"c:\Users\86135\Desktop\CT\projects\dev0.3\frontend\syntax\expr\parse\UnaryExpParser.java", "Java", 0, 0, 50, 0, 1, 9, 60
"c:\Users\86135\Desktop\CT\projects\dev0.3\frontend\syntax\expr\parse\UnaryOpParser.java", "Java", 0, 0, 18, 0, 0, 6, 24
"c:\Users\86135\Desktop\CT\projects\dev0.3\frontend\syntax\func\ast\FuncDefNode.java", "Java", 0, 0, 36, 0, 5, 6, 47
"c:\Users\86135\Desktop\CT\projects\dev0.3\frontend\syntax\func\ast\FuncFParamNode.java", "Java", 0, 0, 44, 0, 5, 9, 58
"c:\Users\86135\Desktop\CT\projects\dev0.3\frontend\syntax\func\ast\FuncFParamsNode.java", "Java", 0, 0, 21, 0, 5, 7, 33
"c:\Users\86135\Desktop\CT\projects\dev0.3\frontend\syntax\func\parse\FuncDefParser.java", "Java", 0, 0, 33, 0, 1, 6, 40
"c:\Users\86135\Desktop\CT\projects\dev0.3\frontend\syntax\func\parse\FuncFParamParser.java", "Java", 0, 0, 38, 0, 1, 6, 45
"c:\Users\86135\Desktop\CT\projects\dev0.3\frontend\syntax\func\parse\FuncFParamsParser.java", "Java", 0, 0, 20, 0, 1, 6, 27
"c:\Users\86135\Desktop\CT\projects\dev0.3\frontend\syntax\func\parse\FuncTypeParser.java", "Java", 0, 0, 18, 0, 1, 4, 23
"c:\Users\86135\Desktop\CT\projects\dev0.3\frontend\syntax\func\parse\MainFuncDefParser.java", "Java", 0, 0, 26, 0, 1, 4, 31
"c:\Users\86135\Desktop\CT\projects\dev0.3\frontend\syntax\stmt\ast\AssignNode.java", "Java", 0, 0, 24, 0, 0, 6, 30
"c:\Users\86135\Desktop\CT\projects\dev0.3\frontend\syntax\stmt\ast\BlockNode.java", "Java", 0, 0, 43, 0, 1, 10, 54
"c:\Users\86135\Desktop\CT\projects\dev0.3\frontend\syntax\stmt\ast\BreakNode.java", "Java", 0, 0, 18, 0, 0, 4, 22
"c:\Users\86135\Desktop\CT\projects\dev0.3\frontend\syntax\stmt\ast\ConditionNode.java", "Java", 0, 0, 24, 0, 0, 6, 30
"c:\Users\86135\Desktop\CT\projects\dev0.3\frontend\syntax\stmt\ast\ContinueNode.java", "Java", 0, 0, 17, 0, 0, 4, 21
"c:\Users\86135\Desktop\CT\projects\dev0.3\frontend\syntax\stmt\ast\GetintNode.java", "Java", 0, 0, 20, 0, 0, 6, 26
"c:\Users\86135\Desktop\CT\projects\dev0.3\frontend\syntax\stmt\ast\LoopNode.java", "Java", 0, 0, 19, 0, 0, 6, 25
"c:\Users\86135\Desktop\CT\projects\dev0.3\frontend\syntax\stmt\ast\PrintNode.java", "Java", 0, 0, 47, 0, 0, 7, 54
"c:\Users\86135\Desktop\CT\projects\dev0.3\frontend\syntax\stmt\ast\ReturnNode.java", "Java", 0, 0, 24, 0, 0, 6, 30
"c:\Users\86135\Desktop\CT\projects\dev0.3\frontend\syntax\stmt\ast\Stmt.java", "Java", 0, 0, 4, 0, 0, 2, 6
"c:\Users\86135\Desktop\CT\projects\dev0.3\frontend\syntax\stmt\parser\BlockParser.java", "Java", 0, 0, 41, 0, 1, 6, 48
"c:\Users\86135\Desktop\CT\projects\dev0.3\frontend\syntax\stmt\parser\StmtParser.java", "Java", 0, 0, 193, 0, 13, 13, 219
"c:\Users\86135\Desktop\CT\projects\dev0.3\frontend\syntax_design.md", "Markdown", 0, 149, 0, 0, 0, 7, 156
"c:\Users\86135\Desktop\CT\projects\dev0.3\frontend\tokenize\FormatStr.java", "Java", 0, 0, 15, 0, 0, 5, 20
"c:\Users\86135\Desktop\CT\projects\dev0.3\frontend\tokenize\Ident.java", "Java", 0, 0, 9, 0, 0, 4, 13
"c:\Users\86135\Desktop\CT\projects\dev0.3\frontend\tokenize\IntConst.java", "Java", 0, 0, 15, 0, 0, 6, 21
"c:\Users\86135\Desktop\CT\projects\dev0.3\frontend\tokenize\Reserved.java", "Java", 0, 0, 6, 0, 0, 2, 8
"c:\Users\86135\Desktop\CT\projects\dev0.3\frontend\tokenize\Token.java", "Java", 0, 0, 108, 0, 21, 21, 150
"c:\Users\86135\Desktop\CT\projects\dev0.3\frontend\tokenize\Tokenizer.java", "Java", 0, 0, 123, 0, 6, 19, 148
"c:\Users\86135\Desktop\CT\projects\dev0.3\out\production\dev0.1\.idea\checkstyle-idea.xml", "XML", 16, 0, 0, 0, 0, 0, 16
"c:\Users\86135\Desktop\CT\projects\dev0.3\out\production\dev0.1\.idea\libraries\Mars_2021.xml", "XML", 9, 0, 0, 0, 0, 0, 9
"c:\Users\86135\Desktop\CT\projects\dev0.3\out\production\dev0.1\.idea\misc.xml", "XML", 11, 0, 0, 0, 0, 0, 11
"c:\Users\86135\Desktop\CT\projects\dev0.3\out\production\dev0.1\.idea\modules.xml", "XML", 8, 0, 0, 0, 0, 0, 8
"c:\Users\86135\Desktop\CT\projects\dev0.3\out\production\dev0.1\Resourse\AutoCompileTest.py", "Python", 0, 0, 0, 49, 3, 3, 55
"c:\Users\86135\Desktop\CT\projects\dev0.3\out\production\dev0.1\Resourse\AutoFiltedPacker.py", "Python", 0, 0, 0, 31, 0, 5, 36
"c:\Users\86135\Desktop\CT\projects\dev0.3\out\production\dev0.1\Resourse\AutoMatchTwo.py", "Python", 0, 0, 0, 47, 3, 3, 53
"c:\Users\86135\Desktop\CT\projects\dev0.3\out\production\dev0.1\Resourse\AutoMidCompare.py", "Python", 0, 0, 0, 55, 6, 4, 65
"c:\Users\86135\Desktop\CT\projects\dev0.3\out\production\dev0.1\Resourse\AutoMipsCompare.py", "Python", 0, 0, 0, 77, 7, 4, 88
"c:\Users\86135\Desktop\CT\projects\dev0.3\out\production\dev0.1\Resourse\AutoRunJar.py", "Python", 0, 0, 0, 28, 1, 3, 32
"c:\Users\86135\Desktop\CT\projects\dev0.3\out\production\dev0.1\Resourse\AutoTestJar.py", "Python", 0, 0, 0, 40, 2, 3, 45
"c:\Users\86135\Desktop\CT\projects\dev0.3\out\production\dev0.1\Resourse\ImportStyleCheck.py", "Python", 0, 0, 0, 26, 0, 3, 29
"c:\Users\86135\Desktop\CT\projects\dev0.3\out\production\dev0.1\Resourse\config.xml", "XML", 149, 0, 0, 0, 10, 10, 169
"c:\Users\86135\Desktop\CT\projects\dev0.3\out\production\dev0.1\dev0.1.iml", "XML", 22, 0, 0, 0, 0, 0, 22
"c:\Users\86135\Desktop\CT\projects\dev0.3\out\production\dev0.2\.idea\artifacts\dev0_2_jar.xml", "XML", 8, 0, 0, 0, 0, 0, 8
"c:\Users\86135\Desktop\CT\projects\dev0.3\out\production\dev0.2\.idea\checkstyle-idea.xml", "XML", 16, 0, 0, 0, 0, 0, 16
"c:\Users\86135\Desktop\CT\projects\dev0.3\out\production\dev0.2\.idea\libraries\Mars_2021.xml", "XML", 9, 0, 0, 0, 0, 0, 9
"c:\Users\86135\Desktop\CT\projects\dev0.3\out\production\dev0.2\.idea\libraries\Mars_20211.xml", "XML", 9, 0, 0, 0, 0, 0, 9
"c:\Users\86135\Desktop\CT\projects\dev0.3\out\production\dev0.2\.idea\misc.xml", "XML", 11, 0, 0, 0, 0, 0, 11
"c:\Users\86135\Desktop\CT\projects\dev0.3\out\production\dev0.2\.idea\modules.xml", "XML", 8, 0, 0, 0, 0, 0, 8
"c:\Users\86135\Desktop\CT\projects\dev0.3\out\production\dev0.2\.idea\vcs.xml", "XML", 6, 0, 0, 0, 0, 0, 6
"c:\Users\86135\Desktop\CT\projects\dev0.3\out\production\dev0.2\Resourse\AutoCompileTest.py", "Python", 0, 0, 0, 49, 3, 3, 55
"c:\Users\86135\Desktop\CT\projects\dev0.3\out\production\dev0.2\Resourse\AutoFiltedPacker.py", "Python", 0, 0, 0, 31, 0, 5, 36
"c:\Users\86135\Desktop\CT\projects\dev0.3\out\production\dev0.2\Resourse\AutoMatchTwo.py", "Python", 0, 0, 0, 47, 3, 3, 53
"c:\Users\86135\Desktop\CT\projects\dev0.3\out\production\dev0.2\Resourse\AutoMidCompare.py", "Python", 0, 0, 0, 55, 6, 4, 65
"c:\Users\86135\Desktop\CT\projects\dev0.3\out\production\dev0.2\Resourse\AutoMipsCompare.py", "Python", 0, 0, 0, 77, 7, 4, 88
"c:\Users\86135\Desktop\CT\projects\dev0.3\out\production\dev0.2\Resourse\AutoRunJar.py", "Python", 0, 0, 0, 28, 1, 3, 32
"c:\Users\86135\Desktop\CT\projects\dev0.3\out\production\dev0.2\Resourse\AutoTestJar.py", "Python", 0, 0, 0, 40, 2, 3, 45
"c:\Users\86135\Desktop\CT\projects\dev0.3\out\production\dev0.2\Resourse\ImportStyleCheck.py", "Python", 0, 0, 0, 26, 0, 3, 29
"c:\Users\86135\Desktop\CT\projects\dev0.3\out\production\dev0.2\Resourse\config.xml", "XML", 149, 0, 0, 0, 10, 10, 169
"c:\Users\86135\Desktop\CT\projects\dev0.3\out\production\dev0.2\autotest\AutoMatchTwo.py", "Python", 0, 0, 0, 47, 3, 3, 53
"c:\Users\86135\Desktop\CT\projects\dev0.3\out\production\dev0.2\dev0.1.iml", "XML", 22, 0, 0, 0, 0, 0, 22
"c:\Users\86135\Desktop\CT\projects\dev0.3\out\production\dev0.2\dev0.2.iml", "XML", 22, 0, 0, 0, 0, 0, 22
"c:\Users\86135\Desktop\CT\projects\dev0.3\out\production\dev0.2\frontend\lang_design.md", "Markdown", 0, 107, 0, 0, 0, 5, 112
"c:\Users\86135\Desktop\CT\projects\dev0.3\out\production\dev0.2\todo_checker.md", "Markdown", 0, 20, 0, 0, 0, 3, 23
"c:\Users\86135\Desktop\CT\projects\dev0.3\out\production\dev0.3\.idea\artifacts\dev0_3_jar.xml", "XML", 8, 0, 0, 0, 0, 0, 8
"c:\Users\86135\Desktop\CT\projects\dev0.3\out\production\dev0.3\.idea\checkstyle-idea.xml", "XML", 16, 0, 0, 0, 0, 0, 16
"c:\Users\86135\Desktop\CT\projects\dev0.3\out\production\dev0.3\.idea\libraries\Compiler_21_dhy.xml", "XML", 9, 0, 0, 0, 0, 0, 9
"c:\Users\86135\Desktop\CT\projects\dev0.3\out\production\dev0.3\.idea\libraries\Mars_2021.xml", "XML", 9, 0, 0, 0, 0, 0, 9
"c:\Users\86135\Desktop\CT\projects\dev0.3\out\production\dev0.3\.idea\libraries\Mars_20211.xml", "XML", 9, 0, 0, 0, 0, 0, 9
"c:\Users\86135\Desktop\CT\projects\dev0.3\out\production\dev0.3\.idea\libraries\Mars_20212.xml", "XML", 9, 0, 0, 0, 0, 0, 9
"c:\Users\86135\Desktop\CT\projects\dev0.3\out\production\dev0.3\.idea\libraries\autotest.xml", "XML", 11, 0, 0, 0, 0, 0, 11
"c:\Users\86135\Desktop\CT\projects\dev0.3\out\production\dev0.3\.idea\libraries\dev0_2.xml", "XML", 9, 0, 0, 0, 0, 0, 9
"c:\Users\86135\Desktop\CT\projects\dev0.3\out\production\dev0.3\.idea\misc.xml", "XML", 11, 0, 0, 0, 0, 0, 11
"c:\Users\86135\Desktop\CT\projects\dev0.3\out\production\dev0.3\.idea\modules.xml", "XML", 8, 0, 0, 0, 0, 0, 8
"c:\Users\86135\Desktop\CT\projects\dev0.3\out\production\dev0.3\.idea\uiDesigner.xml", "XML", 124, 0, 0, 0, 0, 0, 124
"c:\Users\86135\Desktop\CT\projects\dev0.3\out\production\dev0.3\.idea\vcs.xml", "XML", 6, 0, 0, 0, 0, 0, 6
"c:\Users\86135\Desktop\CT\projects\dev0.3\out\production\dev0.3\Resourse\AutoCompileTest.py", "Python", 0, 0, 0, 49, 3, 3, 55
"c:\Users\86135\Desktop\CT\projects\dev0.3\out\production\dev0.3\Resourse\AutoFiltedPacker.py", "Python", 0, 0, 0, 31, 0, 5, 36
"c:\Users\86135\Desktop\CT\projects\dev0.3\out\production\dev0.3\Resourse\AutoMatchTwo.py", "Python", 0, 0, 0, 57, 4, 6, 67
"c:\Users\86135\Desktop\CT\projects\dev0.3\out\production\dev0.3\Resourse\AutoMidCompare.py", "Python", 0, 0, 0, 55, 6, 4, 65
"c:\Users\86135\Desktop\CT\projects\dev0.3\out\production\dev0.3\Resourse\AutoMipsCompare.py", "Python", 0, 0, 0, 77, 7, 4, 88
"c:\Users\86135\Desktop\CT\projects\dev0.3\out\production\dev0.3\Resourse\AutoRunJar.py", "Python", 0, 0, 0, 28, 1, 3, 32
"c:\Users\86135\Desktop\CT\projects\dev0.3\out\production\dev0.3\Resourse\AutoTestJar.py", "Python", 0, 0, 0, 40, 2, 3, 45
"c:\Users\86135\Desktop\CT\projects\dev0.3\out\production\dev0.3\Resourse\ImportStyleCheck.py", "Python", 0, 0, 0, 26, 0, 3, 29
"c:\Users\86135\Desktop\CT\projects\dev0.3\out\production\dev0.3\Resourse\config.xml", "XML", 149, 0, 0, 0, 10, 10, 169
"c:\Users\86135\Desktop\CT\projects\dev0.3\out\production\dev0.3\autotest\AutoMatchTwo.py", "Python", 0, 0, 0, 65, 4, 6, 75
"c:\Users\86135\Desktop\CT\projects\dev0.3\out\production\dev0.3\dev0.1.iml", "XML", 22, 0, 0, 0, 0, 0, 22
"c:\Users\86135\Desktop\CT\projects\dev0.3\out\production\dev0.3\dev0.2.iml", "XML", 22, 0, 0, 0, 0, 0, 22
"c:\Users\86135\Desktop\CT\projects\dev0.3\out\production\dev0.3\dev0.3.iml", "XML", 22, 0, 0, 0, 0, 0, 22
"c:\Users\86135\Desktop\CT\projects\dev0.3\out\production\dev0.3\frontend\lang_design.md", "Markdown", 0, 162, 0, 0, 0, 20, 182
"c:\Users\86135\Desktop\CT\projects\dev0.3\out\production\dev0.3\frontend\syntax_design.md", "Markdown", 0, 149, 0, 0, 0, 7, 156
"c:\Users\86135\Desktop\CT\projects\dev0.3\out\production\dev0.3\todo_checker.md", "Markdown", 0, 58, 0, 0, 0, 14, 72
"c:\Users\86135\Desktop\CT\projects\dev0.3\todo_checker.md", "Markdown", 0, 58, 0, 0, 0, 14, 72
"c:\Users\86135\Desktop\CT\projects\dev0.3\util\Pair.java", "Java", 0, 0, 35, 0, 0, 9, 44
"Total", "-", 1363, 865, 2742, 1609, 257, 860, 7696