"filename", "language", "Python", "Java", "XML", "Markdown", "comment", "blank", "total"
"c:\Users\86135\Desktop\CT\projects\dev0.2\.idea\checkstyle-idea.xml", "XML", 0, 0, 16, 0, 0, 0, 16
"c:\Users\86135\Desktop\CT\projects\dev0.2\.idea\libraries\Mars_2021.xml", "XML", 0, 0, 9, 0, 0, 0, 9
"c:\Users\86135\Desktop\CT\projects\dev0.2\.idea\libraries\Mars_20211.xml", "XML", 0, 0, 9, 0, 0, 0, 9
"c:\Users\86135\Desktop\CT\projects\dev0.2\.idea\misc.xml", "XML", 0, 0, 11, 0, 0, 0, 11
"c:\Users\86135\Desktop\CT\projects\dev0.2\.idea\modules.xml", "XML", 0, 0, 8, 0, 0, 0, 8
"c:\Users\86135\Desktop\CT\projects\dev0.2\Compiler.java", "Java", 0, 12, 0, 0, 0, 4, 16
"c:\Users\86135\Desktop\CT\projects\dev0.2\Resourse\AutoCompileTest.py", "Python", 49, 0, 0, 0, 3, 3, 55
"c:\Users\86135\Desktop\CT\projects\dev0.2\Resourse\AutoFiltedPacker.py", "Python", 31, 0, 0, 0, 0, 5, 36
"c:\Users\86135\Desktop\CT\projects\dev0.2\Resourse\AutoMatchTwo.py", "Python", 47, 0, 0, 0, 3, 3, 53
"c:\Users\86135\Desktop\CT\projects\dev0.2\Resourse\AutoMidCompare.py", "Python", 55, 0, 0, 0, 6, 4, 65
"c:\Users\86135\Desktop\CT\projects\dev0.2\Resourse\AutoMipsCompare.py", "Python", 77, 0, 0, 0, 7, 4, 88
"c:\Users\86135\Desktop\CT\projects\dev0.2\Resourse\AutoRunJar.py", "Python", 28, 0, 0, 0, 1, 3, 32
"c:\Users\86135\Desktop\CT\projects\dev0.2\Resourse\AutoTestJar.py", "Python", 40, 0, 0, 0, 2, 3, 45
"c:\Users\86135\Desktop\CT\projects\dev0.2\Resourse\ImportStyleCheck.py", "Python", 26, 0, 0, 0, 0, 3, 29
"c:\Users\86135\Desktop\CT\projects\dev0.2\Resourse\config.xml", "XML", 0, 0, 149, 0, 10, 10, 169
"c:\Users\86135\Desktop\CT\projects\dev0.2\dev0.1.iml", "XML", 0, 0, 22, 0, 0, 0, 22
"c:\Users\86135\Desktop\CT\projects\dev0.2\dev0.2.iml", "XML", 0, 0, 22, 0, 0, 0, 22
"c:\Users\86135\Desktop\CT\projects\dev0.2\driver\CompilerDriver.java", "Java", 0, 26, 0, 0, 2, 6, 34
"c:\Users\86135\Desktop\CT\projects\dev0.2\driver\Config.java", "Java", 0, 102, 0, 0, 2, 17, 121
"c:\Users\86135\Desktop\CT\projects\dev0.2\driver\Output.java", "Java", 0, 26, 0, 0, 0, 9, 35
"c:\Users\86135\Desktop\CT\projects\dev0.2\frontend\Source.java", "Java", 0, 51, 0, 0, 0, 14, 65
"c:\Users\86135\Desktop\CT\projects\dev0.2\frontend\error\Error.java", "Java", 0, 56, 0, 0, 0, 15, 71
"c:\Users\86135\Desktop\CT\projects\dev0.2\frontend\error\ErrorBuffer.java", "Java", 0, 21, 0, 0, 0, 9, 30
"c:\Users\86135\Desktop\CT\projects\dev0.2\frontend\exceptions\FrontendBaseException.java", "Java", 0, 9, 0, 0, 0, 3, 12
"c:\Users\86135\Desktop\CT\projects\dev0.2\frontend\exceptions\TokenTypeNotFoundException.java", "Java", 0, 6, 0, 0, 0, 3, 9
"c:\Users\86135\Desktop\CT\projects\dev0.2\frontend\lang_design.md", "Markdown", 0, 0, 0, 107, 0, 5, 112
"c:\Users\86135\Desktop\CT\projects\dev0.2\frontend\syntax\CompUnitParser.java", "Java", 0, 51, 0, 0, 1, 4, 56
"c:\Users\86135\Desktop\CT\projects\dev0.2\frontend\syntax\ParserBase.java", "Java", 0, 67, 0, 0, 2, 17, 86
"c:\Users\86135\Desktop\CT\projects\dev0.2\frontend\syntax\decl\parse\BTypeParser.java", "Java", 0, 14, 0, 0, 0, 3, 17
"c:\Users\86135\Desktop\CT\projects\dev0.2\frontend\syntax\decl\parse\ConstDeclParser.java", "Java", 0, 22, 0, 0, 1, 4, 27
"c:\Users\86135\Desktop\CT\projects\dev0.2\frontend\syntax\decl\parse\ConstDefParser.java", "Java", 0, 25, 0, 0, 1, 4, 30
"c:\Users\86135\Desktop\CT\projects\dev0.2\frontend\syntax\decl\parse\ConstInitValParser.java", "Java", 0, 32, 0, 0, 1, 4, 37
"c:\Users\86135\Desktop\CT\projects\dev0.2\frontend\syntax\decl\parse\InitValParser.java", "Java", 0, 32, 0, 0, 1, 4, 37
"c:\Users\86135\Desktop\CT\projects\dev0.2\frontend\syntax\decl\parse\VarDeclParser.java", "Java", 0, 19, 0, 0, 1, 4, 24
"c:\Users\86135\Desktop\CT\projects\dev0.2\frontend\syntax\decl\parse\VarDefParser.java", "Java", 0, 24, 0, 0, 1, 4, 29
"c:\Users\86135\Desktop\CT\projects\dev0.2\frontend\syntax\expr\parse\AddExpParser.java", "Java", 0, 15, 0, 0, 1, 4, 20
"c:\Users\86135\Desktop\CT\projects\dev0.2\frontend\syntax\expr\parse\CondParser.java", "Java", 0, 10, 0, 0, 1, 4, 15
"c:\Users\86135\Desktop\CT\projects\dev0.2\frontend\syntax\expr\parse\ConstExpParser.java", "Java", 0, 10, 0, 0, 1, 4, 15
"c:\Users\86135\Desktop\CT\projects\dev0.2\frontend\syntax\expr\parse\EqExpParser.java", "Java", 0, 15, 0, 0, 1, 4, 20
"c:\Users\86135\Desktop\CT\projects\dev0.2\frontend\syntax\expr\parse\ExpParser.java", "Java", 0, 10, 0, 0, 1, 3, 14
"c:\Users\86135\Desktop\CT\projects\dev0.2\frontend\syntax\expr\parse\FuncRParamsParser.java", "Java", 0, 14, 0, 0, 0, 3, 17
"c:\Users\86135\Desktop\CT\projects\dev0.2\frontend\syntax\expr\parse\LAndExpParser.java", "Java", 0, 15, 0, 0, 1, 4, 20
"c:\Users\86135\Desktop\CT\projects\dev0.2\frontend\syntax\expr\parse\LOrExpParser.java", "Java", 0, 15, 0, 0, 1, 4, 20
"c:\Users\86135\Desktop\CT\projects\dev0.2\frontend\syntax\expr\parse\LValParser.java", "Java", 0, 20, 0, 0, 1, 4, 25
"c:\Users\86135\Desktop\CT\projects\dev0.2\frontend\syntax\expr\parse\MulExpParser.java", "Java", 0, 15, 0, 0, 2, 4, 21
"c:\Users\86135\Desktop\CT\projects\dev0.2\frontend\syntax\expr\parse\NumberParser.java", "Java", 0, 14, 0, 0, 1, 4, 19
"c:\Users\86135\Desktop\CT\projects\dev0.2\frontend\syntax\expr\parse\PrimaryExpParser.java", "Java", 0, 25, 0, 0, 1, 4, 30
"c:\Users\86135\Desktop\CT\projects\dev0.2\frontend\syntax\expr\parse\RelExpParser.java", "Java", 0, 15, 0, 0, 1, 4, 20
"c:\Users\86135\Desktop\CT\projects\dev0.2\frontend\syntax\expr\parse\UnaryExpParser.java", "Java", 0, 41, 0, 0, 1, 4, 46
"c:\Users\86135\Desktop\CT\projects\dev0.2\frontend\syntax\expr\parse\UnaryOpParser.java", "Java", 0, 14, 0, 0, 0, 3, 17
"c:\Users\86135\Desktop\CT\projects\dev0.2\frontend\syntax\func\parse\FuncDefParser.java", "Java", 0, 24, 0, 0, 1, 4, 29
"c:\Users\86135\Desktop\CT\projects\dev0.2\frontend\syntax\func\parse\FuncFParamParser.java", "Java", 0, 28, 0, 0, 1, 4, 33
"c:\Users\86135\Desktop\CT\projects\dev0.2\frontend\syntax\func\parse\FuncFParamsParser.java", "Java", 0, 14, 0, 0, 1, 4, 19
"c:\Users\86135\Desktop\CT\projects\dev0.2\frontend\syntax\func\parse\FuncTypeParser.java", "Java", 0, 14, 0, 0, 1, 4, 19
"c:\Users\86135\Desktop\CT\projects\dev0.2\frontend\syntax\func\parse\MainFuncDefParser.java", "Java", 0, 25, 0, 0, 1, 4, 30
"c:\Users\86135\Desktop\CT\projects\dev0.2\frontend\syntax\stmt\parser\BlockParser.java", "Java", 0, 33, 0, 0, 1, 4, 38
"c:\Users\86135\Desktop\CT\projects\dev0.2\frontend\syntax\stmt\parser\StmtParser.java", "Java", 0, 165, 0, 0, 13, 11, 189
"c:\Users\86135\Desktop\CT\projects\dev0.2\frontend\tokenize\FormatStr.java", "Java", 0, 15, 0, 0, 0, 5, 20
"c:\Users\86135\Desktop\CT\projects\dev0.2\frontend\tokenize\Ident.java", "Java", 0, 9, 0, 0, 0, 4, 13
"c:\Users\86135\Desktop\CT\projects\dev0.2\frontend\tokenize\IntConst.java", "Java", 0, 11, 0, 0, 0, 4, 15
"c:\Users\86135\Desktop\CT\projects\dev0.2\frontend\tokenize\Reserved.java", "Java", 0, 6, 0, 0, 0, 2, 8
"c:\Users\86135\Desktop\CT\projects\dev0.2\frontend\tokenize\Token.java", "Java", 0, 100, 0, 0, 3, 18, 121
"c:\Users\86135\Desktop\CT\projects\dev0.2\frontend\tokenize\Tokenizer.java", "Java", 0, 107, 0, 0, 1, 14, 122
"c:\Users\86135\Desktop\CT\projects\dev0.2\out\production\dev0.1\.idea\checkstyle-idea.xml", "XML", 0, 0, 16, 0, 0, 0, 16
"c:\Users\86135\Desktop\CT\projects\dev0.2\out\production\dev0.1\.idea\libraries\Mars_2021.xml", "XML", 0, 0, 9, 0, 0, 0, 9
"c:\Users\86135\Desktop\CT\projects\dev0.2\out\production\dev0.1\.idea\misc.xml", "XML", 0, 0, 11, 0, 0, 0, 11
"c:\Users\86135\Desktop\CT\projects\dev0.2\out\production\dev0.1\.idea\modules.xml", "XML", 0, 0, 8, 0, 0, 0, 8
"c:\Users\86135\Desktop\CT\projects\dev0.2\out\production\dev0.1\Resourse\AutoCompileTest.py", "Python", 49, 0, 0, 0, 3, 3, 55
"c:\Users\86135\Desktop\CT\projects\dev0.2\out\production\dev0.1\Resourse\AutoFiltedPacker.py", "Python", 31, 0, 0, 0, 0, 5, 36
"c:\Users\86135\Desktop\CT\projects\dev0.2\out\production\dev0.1\Resourse\AutoMatchTwo.py", "Python", 47, 0, 0, 0, 3, 3, 53
"c:\Users\86135\Desktop\CT\projects\dev0.2\out\production\dev0.1\Resourse\AutoMidCompare.py", "Python", 55, 0, 0, 0, 6, 4, 65
"c:\Users\86135\Desktop\CT\projects\dev0.2\out\production\dev0.1\Resourse\AutoMipsCompare.py", "Python", 77, 0, 0, 0, 7, 4, 88
"c:\Users\86135\Desktop\CT\projects\dev0.2\out\production\dev0.1\Resourse\AutoRunJar.py", "Python", 28, 0, 0, 0, 1, 3, 32
"c:\Users\86135\Desktop\CT\projects\dev0.2\out\production\dev0.1\Resourse\AutoTestJar.py", "Python", 40, 0, 0, 0, 2, 3, 45
"c:\Users\86135\Desktop\CT\projects\dev0.2\out\production\dev0.1\Resourse\ImportStyleCheck.py", "Python", 26, 0, 0, 0, 0, 3, 29
"c:\Users\86135\Desktop\CT\projects\dev0.2\out\production\dev0.1\Resourse\config.xml", "XML", 0, 0, 149, 0, 10, 10, 169
"c:\Users\86135\Desktop\CT\projects\dev0.2\out\production\dev0.1\dev0.1.iml", "XML", 0, 0, 22, 0, 0, 0, 22
"c:\Users\86135\Desktop\CT\projects\dev0.2\out\production\dev0.2\.idea\checkstyle-idea.xml", "XML", 0, 0, 16, 0, 0, 0, 16
"c:\Users\86135\Desktop\CT\projects\dev0.2\out\production\dev0.2\.idea\libraries\Mars_2021.xml", "XML", 0, 0, 9, 0, 0, 0, 9
"c:\Users\86135\Desktop\CT\projects\dev0.2\out\production\dev0.2\.idea\libraries\Mars_20211.xml", "XML", 0, 0, 9, 0, 0, 0, 9
"c:\Users\86135\Desktop\CT\projects\dev0.2\out\production\dev0.2\.idea\misc.xml", "XML", 0, 0, 11, 0, 0, 0, 11
"c:\Users\86135\Desktop\CT\projects\dev0.2\out\production\dev0.2\.idea\modules.xml", "XML", 0, 0, 8, 0, 0, 0, 8
"c:\Users\86135\Desktop\CT\projects\dev0.2\out\production\dev0.2\Resourse\AutoCompileTest.py", "Python", 49, 0, 0, 0, 3, 3, 55
"c:\Users\86135\Desktop\CT\projects\dev0.2\out\production\dev0.2\Resourse\AutoFiltedPacker.py", "Python", 31, 0, 0, 0, 0, 5, 36
"c:\Users\86135\Desktop\CT\projects\dev0.2\out\production\dev0.2\Resourse\AutoMatchTwo.py", "Python", 47, 0, 0, 0, 3, 3, 53
"c:\Users\86135\Desktop\CT\projects\dev0.2\out\production\dev0.2\Resourse\AutoMidCompare.py", "Python", 55, 0, 0, 0, 6, 4, 65
"c:\Users\86135\Desktop\CT\projects\dev0.2\out\production\dev0.2\Resourse\AutoMipsCompare.py", "Python", 77, 0, 0, 0, 7, 4, 88
"c:\Users\86135\Desktop\CT\projects\dev0.2\out\production\dev0.2\Resourse\AutoRunJar.py", "Python", 28, 0, 0, 0, 1, 3, 32
"c:\Users\86135\Desktop\CT\projects\dev0.2\out\production\dev0.2\Resourse\AutoTestJar.py", "Python", 40, 0, 0, 0, 2, 3, 45
"c:\Users\86135\Desktop\CT\projects\dev0.2\out\production\dev0.2\Resourse\ImportStyleCheck.py", "Python", 26, 0, 0, 0, 0, 3, 29
"c:\Users\86135\Desktop\CT\projects\dev0.2\out\production\dev0.2\Resourse\config.xml", "XML", 0, 0, 149, 0, 10, 10, 169
"c:\Users\86135\Desktop\CT\projects\dev0.2\out\production\dev0.2\dev0.1.iml", "XML", 0, 0, 22, 0, 0, 0, 22
"c:\Users\86135\Desktop\CT\projects\dev0.2\out\production\dev0.2\dev0.2.iml", "XML", 0, 0, 22, 0, 0, 0, 22
"c:\Users\86135\Desktop\CT\projects\dev0.2\out\production\dev0.2\frontend\lang_design.md", "Markdown", 0, 0, 0, 107, 0, 5, 112
"c:\Users\86135\Desktop\CT\projects\dev0.2\out\production\dev0.2\todo_checker.md", "Markdown", 0, 0, 0, 13, 0, 1, 14
"c:\Users\86135\Desktop\CT\projects\dev0.2\todo_checker.md", "Markdown", 0, 0, 0, 13, 0, 1, 14
"c:\Users\86135\Desktop\CT\projects\dev0.2\util\Pair.java", "Java", 0, 35, 0, 0, 0, 9, 44
"c:\Users\86135\Desktop\CT\projects\submit0.1\Compiler.java", "Java", 0, -12, 0, 0, 0, -4, -16
"c:\Users\86135\Desktop\CT\projects\submit0.1\driver\CompilerDriver.java", "Java", 0, -23, 0, 0, -1, -5, -29
"c:\Users\86135\Desktop\CT\projects\submit0.1\driver\Config.java", "Java", 0, -102, 0, 0, -2, -17, -121
"c:\Users\86135\Desktop\CT\projects\submit0.1\frontend\Source.java", "Java", 0, -51, 0, 0, 0, -14, -65
"c:\Users\86135\Desktop\CT\projects\submit0.1\frontend\exceptions\FrontendBaseException.java", "Java", 0, -9, 0, 0, 0, -3, -12
"c:\Users\86135\Desktop\CT\projects\submit0.1\frontend\exceptions\TokenTypeNotFoundException.java", "Java", 0, -6, 0, 0, 0, -3, -9
"c:\Users\86135\Desktop\CT\projects\submit0.1\frontend\tokenize\FormatStr.java", "Java", 0, -15, 0, 0, 0, -5, -20
"c:\Users\86135\Desktop\CT\projects\submit0.1\frontend\tokenize\Ident.java", "Java", 0, -9, 0, 0, 0, -4, -13
"c:\Users\86135\Desktop\CT\projects\submit0.1\frontend\tokenize\IntConst.java", "Java", 0, -11, 0, 0, 0, -4, -15
"c:\Users\86135\Desktop\CT\projects\submit0.1\frontend\tokenize\Reserved.java", "Java", 0, -6, 0, 0, 0, -2, -8
"c:\Users\86135\Desktop\CT\projects\submit0.1\frontend\tokenize\Token.java", "Java", 0, -99, 0, 0, -3, -17, -119
"c:\Users\86135\Desktop\CT\projects\submit0.1\frontend\tokenize\Tokenizer.java", "Java", 0, -69, 0, 0, -1, -8, -78
"Total", "-", 1059, 1017, 707, 240, 139, 316, 3478